stage000,
F,0,0,1,2,3,4,1,2,2,1,2,0,0,0,0,0,0,0,0,0,
S,0,2,0,0,0,0,0,0,0,0,0,0,0,0,0,0,0,0,0,0,
B,1,2,3,0,1,2,3,0,1,1,2,3,0,0,0,0,0,0,0,0,
G,0,
n,
stage001,
F,0,0,1,2,3,4,0,0,1,2,3,4,0,0,1,2,3,4,0,0,
S,8,9,0,0,1,0,1,0,1,0,0,2,0,0,1,0,0,0,0,0,
B,0,1,0,1,0,2,0,0,0,0,0,0,0,0,0,0,0,0,0,0,
G,3,
n,
stage002,
F,0,0,1,2,3,4,1,2,2,1,2,0,0,0,0,0,0,0,0,0,
S,0,0,0,0,0,0,0,0,0,0,0,0,0,0,0,0,0,0,0,0,
B,3,3,3,3,3,3,3,3,1,1,2,3,0,0,0,0,0,0,0,0,
G,0,
n,
stage003,