stage000,n
0,0,1,2,3,4,1,2,2,1,2,0,0,0,0,0,0,0,0,0,n
5,5,5,5,5,5,5,5,5,5,5,5,5,5,5,5,5,5,5,5,n
1,2,3,0,1,2,3,0,1,1,2,3,0,0,0,0,0,0,0,0,n
stage001,n
0,0,1,2,3,4,1,2,2,1,2,0,0,0,0,0,0,0,0,0,n
5,5,5,5,5,5,5,5,5,5,5,5,5,5,5,5,5,5,5,5,n
1,2,2,2,2,2,2,2,1,1,2,3,0,0,0,0,0,0,0,0,n
stage002,n
0,0,1,2,3,4,1,2,2,1,2,0,0,0,0,0,0,0,0,0,n
5,5,5,5,5,5,5,5,5,5,5,5,5,5,5,5,5,5,5,5,n
3,3,3,3,3,3,3,3,1,1,2,3,0,0,0,0,0,0,0,0,n
stage003