stage000,
0,0,1,2,3,4,1,2,2,1,2,0,0,0,0,0,0,0,0,0,
0,2,0,0,0,0,0,0,0,0,0,0,0,0,0,0,0,0,0,0,
1,2,3,0,1,2,3,0,1,1,2,3,0,0,0,0,0,0,0,0,
stage001,
0,0,1,2,3,4,0,0,1,2,3,4,0,0,1,2,3,4,0,0,
8,9,2,2,2,2,0,0,0,0,0,2,0,0,0,1,0,0,0,0,
0,1,0,1,0,2,0,0,0,0,0,0,0,0,0,0,0,0,0,0,
stage002,
0,0,1,2,3,4,1,2,2,1,2,0,0,0,0,0,0,0,0,0,
0,0,0,0,0,0,0,0,0,0,0,0,0,0,0,0,0,0,0,0,
3,3,3,3,3,3,3,3,1,1,2,3,0,0,0,0,0,0,0,0,
stage003